v v v v v v v v v v v v v a a a a a a a a a a a a a a a a a a a a a a a a a a a a a a a a a
v v v v v v v v v v v v v a a a a a g h a a a a a a i a a a a g h a a a a a a g h a a a a a
v v v v v v v v v v v v v a a a a a a a a a a a a a a a a a a a a a a a a a a a a a a a a a
v v v v v v v v v v v v v a d d d d d d d d d d d d d d d d d d d d d d d d d d d d d d d a
a a a a a a a a a a a a a a a a a a a a a a a a a a a a a a a a a a a a a a a a a a a a a a
a a a a a a a a a a a a a a a a a a a a a a a a a a a a a a a a a a a a a a a a a a a a l a
a d d d d f d d d d d d d d d d d d d d d d d d d d d d d d f d d d d d d d d d d d d d d a
a a a a a a a a a a a j a a a a a a a a a a a a a a a a a a a a a a a a a a a a j a a a a a
a a a a a a a a a a a a a a a a a a a a a a a a a a a a a a a a a a a a a a a a a a a a a a
a a a a a a a a a a a a a a a a a a a a a a a a a a a a a a a a a a a a a a a a a a a a a a
a a a a a a a a g h a a a a a a a a a a a a a a a g h a a a a a a a a g h a a a a a a a a a
a d d d d d d d d d d f d d d d d d d d d d d d d d d d d d d d d d d d d d d d d d d d d a
a a a j a a a a a a a a a a a a a a a a a a a a a a a a a a a a a a a a a a a a a a a a a a
a a a a a a a a a a a a a a a a a a a a a a a a a a a a a a a a a a a a a a a a a a a a a a
v v v v v v v v v v v v v a a a a a a a a a a a a a a a a a a a a a a a a a a a a a a a l a
v v v v v v v v v v v v v a d d d d f d d d d d d d d d d d d f d d d d d d d d d d d d d a
v v v v v v v v v v v v v a a j a a a a a a a a a a a a k a a a a a a a a a a a a a a j a a
v v v v v v v v v v v v v a a a a a a a a a a a a a a a a a a a a a a a a a a a a a a a a a
