a a a a a a a a a a a a a a a a a a a a a a a a a a a a a a a a a a a a a a a a
a v v v v v v v v v v v v v v v v v v v v v v v v v v v v v v v v v v v v v v a
a v v v v v v v v v v v v v v v v v v v v v v v v v v v v v v v v v v v v v v a
a v v v v v v v v v v v v v v v v v v q v r v v v v v v v v v v v v v v v v v a
a v v v v v v v v v v v v v v v v v v v v v v v v v v v v v v v v v v v v v v a
a v s v t v v v v v v v v v v v v v v v v v v v v v v v v v v v v v v v v v v a
a v v v v v v v v v v v v v v v v v v v v v v v v v v v v v v v v v v v v v v a
a a a a a a a a a a a a a a a a a a v v v v v a a a a a a a a a a v v v v v v a
a v v v v v v v v v v v v v v v v v v v v v v v v v v v v v a a a v v v v v v a
a v v v v v v v v v v v v v v v v v v v v v v v v v v v v v v a a a a v v v v a
a v v v v v v v v v v v v v v v v v v v v v v v v v v v v v v v v v v v v v v a
a v v v v v v v v v v v v v v v v v v v v v v v v v v v v v v v v v v v v v v a
a v v v v v v v v v v v v v v v v v v v v v v v v v v v v v v v v v v v a a a a
a v v v v v v v v v v v v v v v v v v v v v v v v v v v v v v v v v v v a a a a
a v v v v v v v q v v v v v v v v v v v v v r v v v v v v v v v v v v v a a a a
a v v v v v v v v v v a a a v v v v v v v v v v v a a a v v v v v v a a a a a a
a v v v v v v v v v v v v v v v v v v v v v v v v v v v v v v v v v a a a a a a
a v v v v v a a v v v v v v v v v a a a a a v v v v v v v v v a a a a a a a a a
a v v v v v a a l m m m m m m m n a a a a a l m m m m m m m n a a a a a a a a a
a v v v v v w w w w w w w w w w w w w w w w w w w w w w w w w w w w w w w w w a
a a a a v v v v v v v v v v v v v v v v v v v v v v v v v v v v v v v v v v v a
a a a a v v v v v v v v v v v v v v v v v v v v v v v v v v v v v v v v v v v a
a a a a v v v v v v v v v v v v v v v v v v v v v v v v v v v v v v v v v v v a
a a a a a a a a a a a a a a a a a a a a a a a a a a a a a a a a a a a a v v v a
a v v v v v v v v v v v v v v v v v v v v v v v v v v v v v v v v v v v v v v a
a v v v v v v v v v v r v v v v v v v v v v v v v v v q v v v v v v v v v v v a
a v v v v v v v v v v v v v v v v v v v v v v v v v v v v v v v v v v v v a a a
a v v v v v v v e f f f f f g v v v v v v v v v b c c c c c d v v v v v v a a a
a v o p v v v v w w w w w w w v v v v v v v v v w w w w w w w v v v v a a a a a
a v v v v v v v v v v v v v v v v v v v v v v v v v v v v v v v v v v a a a a a
a a a a a a a b c c c c c c c d a a a a a a a e f f f f f f f g a a a a a a a a