v v v v v v v v v v v v v a a a a a a a a a a a a a a a a a a a a a a a a a a a a a a a a a
v v v v v v v v v v v v v a v v v v v v v v v v v v v v v v v v v v v v v v v v v v v v v a
v v v v v v v v v v v v v a v v v v v v v v v r v v v v v v v v v v v r v v v v v v v v v a
v v v v v v v v v v v v v a v v v v v v v v v v v v v v v v v v v v v v v v v v v v v v v a
a a a a a a a a a a a a a a v v v v v v v v v v v v v v v v v v v v v v v v v v v v v v v a
a v v v v v v v v v v v v v v v v v v v v v v v v v v v v v v v v v v v v v v v v v v v v a
a v p v v v v v v v v v v v v v v v v v v a v v v a v v v v v v v a v v v a v v v v v t v a
a v v v v v v v v v v v r v v v v v v v a a c c c a a v v v v v a a m m m a a v v v v v v a
a a a a a e f f g a a a a a a a a a a a a a a a a a a a a a a a a a a a a a a a a a a a a a
a a a a a a a a a a a a a a a a a a a a a a a a a a a a a a a a a a a a a a a a a a a a a a
a v v v v v v v v v v v v v v v v v v v v v v v v v v v v v v v v v v v v v v v v v v v v a
a v o v v v v v v v v v v v v v v v v v v v v q v v v v v v v v v v v q v v v v v v v v v a
a v v v v v v v v v v v q v v v v v v v v v v v v v v v v v v v v v v v v v v v v v v v v a
a a a a a b c c d a a a a a v v v v v v v v v v v v v v v v v v v v v v v v v v v v v v v a
v v v v v v v v v v v v v a v v v v v v v v v v v v v v v v v v v v v v v v v v v v v v v a
v v v v v v v v v v v v v a v v v v v v v a v v v a v v v v v v v a v v v a v v v v v s v a
v v v v v v v v v v v v v a v v v v v v a a f f f a a v v v v v a a m m m a a v v v v v v a
v v v v v v v v v v v v v a a a a a a a a a a a a a a a a a a a a a a a a a a a a a a a a a